S********1
         *
B1121211 *
*      2 *
* 123E 1 *
* 2    B 1
* 33BWW2 *
*        *
1211*112WB