***** **** ***********
***** **** E *********
***** ****      ********
***** ******* ********
***** *******     ********
***** ****    *******
***** ****************
***** *********
*****  ***************
******     **********
***S******* **********
*********** **********
**********  *********
**********************
**********************
